Aruba	Aruba
Afghanistan	Afghanistan
Angola	Angola
Anguilla	Anguilla
Albania	Albania
Aland	Aland
Andorra	Andorra
United Arab Emirates	United Arab Emirates, UAE, U.A.E, U.A.E.
Argentina	Argentina
Armenia	Armenia
American Samoa	American Samoa
Antarctica	Antarctica
Ashmore and Cartier Is.	Ashmore, Cartier Island
Fr. S. and Antarctic Lands	Fr. S. and Antarctic Lands
Antigua and Barb.	Antigua, Barbuda
Australia	Australia
Austria	Austria
Azerbaijan	Azerbaijan
Burundi	Burundi
Belgium	Belgium
Benin	Benin
Burkina Faso	Burkina Faso
Bangladesh	Bangladesh
Bulgaria	Bulgaria
Bahrain	Bahrain
Bahamas	Bahamas
Bosnia and Herz.	Bosnia, Herzegovina
St. Barthelemy	St. Barthelemy, St Barthelemy
Belarus	Belarus
Belize	Belize
Bermuda	Bermuda
Bolivia	Bolivia
Brazil	Brazil
Barbados	Barbados
Brunei	Brunei
Bhutan	Bhutan
Botswana	Botswana
Central African Rep.	Central African Rep., Central Africa
Canada	Canada
Switzerland	Switzerland
Chile	Chile
China	China
Ivory Coast	Ivory Coast, Côte d'Ivoire, Cote d'Ivoire
Cameroon	Cameroon
Congo (Kinshasa)	Congo
Congo (Brazzaville)	Congo
Cook Is.	Cook Is., Cook Island
Colombia	Colombia
Comoros	Comoros
Cape Verde	Cape Verde
Costa Rica	Costa Rica
Cuba	Cuba
Cayman Is.	Cayman Is., Cayman Islands
N. Cyprus	N. Cyprus, Northern Cyprus, North Cyprus
Cyprus	Cyprus
Czech Rep.	Czech Rep., Czech Republic, Czechia
Germany	Germany, Deutschland
Djibouti	Djibouti
Dominica	Dominica
Denmark	Denmark
Dominican Rep.	Dominican
Algeria	Algeria
Ecuador	Ecuador
Egypt	Egypt
Eritrea	Eritrea
Spain	Spain
Estonia	Estonia
Ethiopia	Ethiopia
Finland	Finland
Fiji	Fiji
Falkland Is.	Falkland
France	France
Faroe Is.	Faroe 
Micronesia	Micronesia
Gabon	Gabon
Gaza	Gaza
United Kingdom	United Kingdom, UK, England, Scotland, Wales, Britain, U.K., U.K
Georgia	Georgia
Guernsey	Guernsey
Ghana	Ghana
Guinea	Guinea
Gambia	Gambia
Guinea Bissau	Guinea Bissau, Guinea-Bissau
Eq. Guinea	Eq. Guinea, Equatorial Guinea, Eq Guinea
Greece	Greece
Grenada	Grenada
Greenland	Greenland
Guatemala	Guatemala
Guam	Guam
Guyana	Guyana
Hong Kong	Hong Kong
Heard I. and McDonald Is.	Heard I. and McDonald Is.
Honduras	Honduras
Croatia	Croatia
Haiti	Haiti
Hungary	Hungary
Indonesia	Indonesia
Isle of Man	Isle of Man, Isle of Maan
India	India
Indian Ocean Ter.	Indian Ocean Ter.
Br. Indian Ocean Ter.	Br. Indian Ocean Ter.
Ireland	Ireland
Iran	Iran Persia
Iraq	Iraq
Iceland	Iceland
Israel	Israel
Italy	Italy
Jamaica	Jamaica
Jersey	Jersey
Jordan	Jordan
Japan	Japan Nippon
Kashmir	Kashmir
Kazakhstan	Kazakhstan
Kenya	Kenya
Kyrgyzstan	Kyrgyzstan
Cambodia	Cambodia
Kiribati	Kiribati
St. Kitts and Nevis	St. Kitts, St Kitts, Nevis
S. Korea	Korea
Kosovo	Kosovo
Kuwait	Kuwait
Laos	Laos
Lebanon	Lebanon
Liberia	Liberia
Libya	Libya
Saint Lucia	Saint Lucia, St Lucia, St. Lucia
Liechtenstein	Liechtenstein
Sri Lanka	Sri Lanka
Lesotho	Lesotho
Lithuania	Lithuania
Luxembourg	Luxembourg
Latvia	Latvia
Macau	Macau
St. Martin	St. Martin, St Martin
Morocco	Morocco
Monaco	Monaco
Moldova	Moldova
Madagascar	Madagascar
Maldives	Maldives
Mexico	Mexico
Marshall Is.	Marshall Is., Marshall Island
Macedonia	Macedonia
Mali	Mali
Malta	Malta
Myanmar	Myanmar, Burma
Montenegro	Montenegro
Mongolia	Mongolia
N. Mariana Is.	N. Mariana Is.
Mozambique	Mozambique
Mauritania	Mauritania
Montserrat	Montserrat
Mauritius	Mauritius
Malawi	Malawi
Malaysia	Malaysia
Namibia	Namibia
New Caledonia	New Caledonia
Niger	Niger
Norfolk Island	Norfolk Island
Nigeria	Nigeria
Nicaragua	Nicaragua
Niue	Niue
Netherlands	Netherlands
Norway	Norway
Nepal	Nepal
Nauru	Nauru
New Zealand	New Zealand
Oman	Oman
Pakistan	Pakistan
Panama	Panama
Pitcairn Is.	Pitcairn Is., Pitcairn Island
Peru	Peru
Philippines	Philippines
Palau	Palau
Papua New Guinea	New Guinea
Poland	Poland
Puerto Rico	Puerto Rico
N. Korea	Korea
Portugal	Portugal
Paraguay	Paraguay
Fr. Polynesia	Fr. Polynesia, Polynesia
Qatar	Qatar
Romania	Romania
Russia	Russia
Rwanda	Rwanda
W. Sahara	W. Sahara, Western Sahara
Saudi Arabia	Saudi Arabia
Sudan	Sudan
S. Sudan	S. Sudan, S Sudan
Senegal	Senegal
Singapore	Singapore
S. Geo. and S. Sandw. Is.	S. Geo. and S. Sandw. Is.
Saint Helena	Saint Helena
Solomon Is.	Solomon Is., Solomon Island
Sierra Leone	Sierra Leone
El Salvador	El Salvador
San Marino	San Marino
Somaliland	Somaliland
Somalia	Somalia
St. Pierre and Miquelon	St. Pierre, Miquelon, St Pierre
Serbia	Serbia
Sao Tome and Principe	Sao Tome, Principe
Suriname	Suriname
Slovakia	Slovakia
Slovenia	Slovenia
Sweden	Sweden
Swaziland	Swaziland
Sint Maarten	Sint Maarten
Seychelles	Seychelles
Syria	Syria
Turks and Caicos Is.	Caicos
Chad	Chad
Togo	Togo
Thailand	Thailand
Tajikistan	Tajikistan
Turkmenistan	Turkmenistan
East Timor	East Timor
Tonga	Tonga
Trinidad and Tobago	Trinidad, Tobago
Tunisia	Tunisia
Turkey	Turkey
Taiwan	Taiwan
Tanzania	Tanzania
Uganda	Uganda
Ukraine	Ukraine
Uruguay	Uruguay
United States	United States, USA, America, U.S.A.
Uzbekistan	Uzbekistan
Vatican	Vatican
St. Vin. and Gren.	St. Vin. and Gren., St Vincent, St. Vincent, Grenadines
Venezuela	Venezuela
British Virgin Is.	British Virgin Is., Virgin Islands
U.S. Virgin Is.	U.S. Virgin Is., Virgin Islands
Vietnam	Vietnam
Vanuatu	Vanuatu
West Bank	West Bank, Palestine
Wallis and Futuna	Wallis, Futuna
Samoa	Samoa
Yemen	Yemen
South Africa	South Africa
Zambia	Zambia
Zimbabwe	Zimbabwe
